lemma	PoS
the	a
be	v
and	c
a	a
of	i
to	t
in	i
i	p
you	p
it	p
have	v
to	i
that	c
for	i
do	v
he	p
with	i
on	i
this	d
n't	x
we	p
that	d
not	x
but	c
they	p
say	v
at	i
what	d
his	a
from	i
go	v
or	c
by	i
get	v
she	p
my	a
can	v
as	c
know	v
if	c
me	p
your	a
all	d
who	p
about	i
their	a
will	v
so	r
would	v
make	v
just	r
up	r
think	v
time	n
there	e
see	v
her	a
as	i
out	r
one	m
come	v
people	n
take	v
year	n
him	p
them	p
some	d
want	v
how	r
when	c
which	d
now	r
like	i
other	j
could	v
our	a
into	i
here	r
then	r
than	c
look	v
way	n
more	r
these	d
no	a
thing	n
well	r
because	c
also	r
two	m
use	v
tell	v
good	j
first	m
man	n
day	n
find	v
give	v
more	d
new	j
one	p
us	p
any	d
those	d
very	r
her	p
need	v
back	r
there	r
should	v
even	r
only	r
many	d
really	r
work	v
life	n
why	r
right	r
down	r
on	r
try	v
let	v
something	p
too	r
call	v
woman	n
may	v
still	r
through	i
mean	v
after	i
never	r
no	u
world	n
in	r
feel	v
yeah	u
great	j
last	m
child	n
oh	u
over	i
ask	v
when	r
as	r
school	n
state	n
much	d
talk	v
out	i
keep	v
leave	v
put	v
like	v
help	v
big	j
where	r
same	d
all	r
own	d
while	c
start	v
three	m
high	j
every	a
another	d
become	v
most	r
between	i
happen	v
family	n
over	r
president	n
old	j
yes	u
house	n
show	v
again	r
student	n
so	c
seem	v
might	v
part	n
hear	v
its	a
place	n
problem	n
where	c
believe	v
country	n
always	r
week	n
point	n
hand	n
off	r
play	v
turn	v
few	d
group	n
such	d
against	i
run	v
guy	n
about	r
case	n
question	n
work	n
night	n
live	v
game	n
number	n
write	v
bring	v
without	i
money	n
lot	n
most	d
book	n
system	n
government	n
next	m
city	n
company	n
story	n
today	r
job	n
move	v
must	v
bad	j
friend	n
during	i
begin	v
love	v
each	d
hold	v
different	j
american	j
little	j
before	i
ever	r
word	n
fact	n
right	n
read	v
anything	p
nothing	p
sure	j
small	j
month	n
program	n
maybe	r
right	j
under	i
business	n
home	n
kind	n
stop	v
pay	v
study	n
since	c
issue	n
name	n
idea	n
room	n
percent	n
far	r
away	r
law	n
actually	r
large	j
though	c
provide	v
lose	v
power	n
kid	n
war	n
understand	v
head	n
mother	n
real	j
best	j
team	n
eye	n
long	r
long	j
side	n
water	n
young	j
wait	v
okay	r
both	d
yet	r
after	c
meet	v
service	n
area	n
important	j
person	n
hey	u
thank	v
much	r
someone	p
end	n
change	v
however	r
only	j
around	r
hour	n
everything	p
national	j
four	m
line	n
girl	n
around	i
watch	v
until	c
father	n
sit	v
create	v
information	n
car	n
learn	v
least	r
already	r
kill	v
minute	n
party	n
include	v
stand	v
together	r
back	n
follow	v
health	n
remember	v
often	r
reason	n
speak	v
ago	r
set	v
black	j
member	n
community	n
once	r
social	j
news	n
allow	v
win	v
body	n
lead	v
continue	v
whether	c
enough	r
spend	v
level	n
able	j
political	j
almost	r
boy	n
university	n
before	c
stay	v
add	v
later	r
change	n
five	m
probably	r
center	n
among	i
face	n
public	j
die	v
food	n
else	r
history	n
buy	v
result	n
morning	n
off	i
parent	n
office	n
course	r
send	v
research	n
walk	v
door	n
white	j
several	d
court	n
home	r
grow	v
better	j
open	v
moment	n
including	i
consider	v
both	r
such	i
little	r
within	i
second	m
late	j
street	n
free	j
better	r
everyone	p
policy	n
table	n
sorry	j
care	n
low	j
human	j
please	r
hope	v
1	j
process	n
teacher	n
data	n
offer	v
death	n
whole	j
experience	n
plan	n
easy	j
education	n
build	v
expect	v
fall	v
himself	p
age	n
hard	j
sense	n
across	i
show	n
early	j
college	n
music	n
appear	v
mind	n
class	n
police	n
use	n
effect	n
season	n
tax	n
heart	n
son	n
art	n
possible	j
serve	v
break	v
although	c
end	v
market	n
even	c
air	n
force	n
require	v
foot	n
up	i
listen	v
agree	v
according	i
anyone	p
baby	n
wrong	j
love	n
cut	v
decide	v
republican	n
full	j
behind	i
pass	v
interest	n
sometimes	r
security	n
eat	v
report	v
control	n
rate	n
local	j
suggest	v
report	n
nation	n
sell	v
action	n
support	v
wife	n
decision	n
receive	v
value	n
base	v
pick	v
phone	n
thanks	n
event	n
drive	v
strong	j
reach	v
remain	v
explain	v
site	n
hit	v
pull	v
church	n
model	n
perhaps	r
relationship	n
six	m
fine	j
movie	n
field	n
raise	v
less	r
player	n
couple	n
million	m
themselves	p
record	n
especially	r
difference	n
light	n
development	n
federal	j
former	d
role	n
pretty	r
myself	p
view	n
price	n
effort	n
nice	j
quite	r
along	i
voice	n
finally	r
department	n
either	r
toward	i
leader	n
because	i
photo	n
wear	v
space	n
project	n
return	v
position	n
special	j
million	n
film	n
need	n
major	j
type	n
town	n
article	n
road	n
form	n
chance	n
drug	n
economic	j
situation	n
choose	v
practice	n
cause	v
happy	j
science	n
join	v
teach	v
early	r
develop	v
share	v
yourself	p
carry	v
clear	j
brother	n
matter	n
dead	j
image	n
star	n
cost	n
simply	r
post	n
society	n
picture	n
piece	n
paper	n
energy	n
personal	j
building	n
military	j
open	j
doctor	n
activity	n
exactly	r
american	n
media	n
miss	v
evidence	n
product	n
realize	v
save	v
arm	n
technology	n
catch	v
comment	n
look	n
term	n
color	n
cover	v
describe	v
guess	v
choice	n
source	n
mom	n
soon	r
director	n
international	j
rule	n
campaign	n
ground	n
election	n
face	v
uh	u
check	v
page	n
fight	v
itself	p
test	n
patient	n
produce	v
certain	j
whatever	d
half	d
video	n
support	n
throw	v
third	m
care	v
rest	n
recent	j
available	j
step	n
ready	j
opportunity	n
official	n
oil	n
call	n
organization	n
character	n
single	j
current	j
likely	j
county	n
future	n
dad	n
whose	d
less	d
shoot	v
industry	n
second	n
list	n
general	j
stuff	n
figure	n
attention	n
forget	v
risk	n
no	r
focus	v
short	j
fire	n
dog	n
red	j
hair	n
point	v
condition	n
wall	n
daughter	n
before	r
deal	n
author	n
truth	n
upon	i
husband	n
period	n
series	n
order	n
officer	n
close	j
land	n
note	v
computer	n
thought	n
economy	n
goal	n
bank	n
behavior	n
sound	v
deal	v
certainly	r
nearly	r
increase	v
act	n
north	n
well	i
blood	n
culture	n
medical	j
ok	r
everybody	p
top	n
difficult	j
close	v
language	n
window	n
response	n
population	n
lie	v
tree	n
park	n
worker	n
draw	v
plan	v
drop	v
push	v
earth	n
cause	n
per	i
private	j
tonight	r
race	n
than	i
letter	n
other	p
gun	n
simple	j
course	n
wonder	v
involve	v
hell	n
poor	j
each	p
answer	n
nature	n
administration	n
common	j
no	p
hard	r
message	n
song	n
enjoy	v
similar	j
congress	n
attack	n
past	j
hot	j
seek	v
amount	n
analysis	n
store	n
defense	n
bill	n
like	c
cell	n
away	i
performance	n
hospital	n
bed	n
board	n
protect	v
century	n
summer	n
material	n
individual	n
recently	r
example	n
represent	v
fill	v
state	v
place	v
animal	n
fail	v
factor	n
natural	j
sir	n
agency	n
usually	r
significant	j
help	n
ability	n
mile	n
statement	n
entire	j
democrat	n
floor	n
serious	j
career	n
dollar	n
vote	v
sex	n
compare	v
south	n
forward	r
subject	n
financial	j
identify	v
beautiful	j
decade	n
bit	n
reduce	v
sister	n
quality	n
quickly	r
act	v
press	n
worry	v
accept	v
enter	v
mention	v
sound	n
thus	r
plant	n
movement	n
scene	n
section	n
treatment	n
wish	v
benefit	n
interesting	j
west	n
candidate	n
approach	n
determine	v
resource	n
claim	v
answer	v
prove	v
sort	n
enough	d
size	n
somebody	p
knowledge	n
rather	r
hang	v
sport	n
tv	n
loss	n
argue	v
left	j
note	n
meeting	n
skill	n
card	n
feeling	n
despite	i
degree	n
crime	n
that	r
sign	n
occur	v
imagine	v
vote	n
near	i
king	n
box	n
present	v
figure	v
seven	m
foreign	j
laugh	v
disease	n
lady	n
beyond	i
discuss	v
finish	v
design	n
concern	n
ball	n
east	n
recognize	v
apply	v
prepare	v
network	n
huge	j
success	n
district	n
cup	n
name	v
physical	j
growth	n
rise	v
hi	u
standard	n
force	v
sign	v
fan	n
theory	n
staff	n
hurt	v
legal	j
september	n
set	n
outside	i
et	r
strategy	n
clearly	r
property	n
lay	v
final	j
authority	n
perfect	j
method	n
region	n
since	i
impact	n
indicate	v
safe	j
committee	n
supposed	j
dream	n
training	n
shit	n
central	j
option	n
eight	m
particularly	r
completely	r
opinion	n
main	j
ten	m
interview	n
exist	v
remove	v
dark	j
play	n
union	n
professor	n
pressure	n
purpose	n
stage	n
blue	j
herself	p
sun	n
pain	n
artist	n
employee	n
avoid	v
account	n
release	v
fund	n
environment	n
treat	v
specific	j
version	n
shot	n
hate	v
reality	n
visit	v
club	n
justice	n
river	n
brain	n
memory	n
rock	n
talk	n
camera	n
global	j
various	j
arrive	v
notice	v
bit	r
detail	n
challenge	n
argument	n
lot	r
nobody	p
weapon	n
best	r
station	n
island	n
absolutely	r
instead	r
discussion	n
instead	i
affect	v
design	v
little	d
anyway	r
respond	v
control	v
trouble	n
conversation	n
manage	v
close	r
date	n
public	n
army	n
top	j
post	v
charge	n
seat	n
assume	v
writer	n
perform	v
credit	n
green	j
marriage	n
operation	n
indeed	r
sleep	v
necessary	j
reveal	v
agent	n
access	n
bar	n
debate	n
leg	n
contain	v
beat	v
cool	j
democratic	j
cold	j
glass	n
improve	v
adult	n
trade	n
religious	j
head	v
review	n
kind	r
address	v
association	n
measure	n
stock	n
gas	n
deep	j
lawyer	n
production	n
relate	v
middle	j
management	n
original	j
victim	n
cancer	n
speech	n
particular	j
trial	n
none	p
item	n
weight	n
tomorrow	r
step	v
positive	j
form	v
citizen	n
study	v
trip	n
establish	v
executive	n
politics	n
stick	v
customer	n
manager	n
rather	i
publish	v
popular	j
sing	v
ahead	r
conference	n
total	j
discover	v
fast	r
base	n
direction	n
sunday	n
maintain	v
past	n
majority	n
peace	n
dinner	n
partner	n
user	n
above	i
fly	v
bag	n
therefore	r
rich	j
individual	j
tough	j
owner	n
shall	v
inside	i
voter	n
tool	n
june	n
far	j
may	n
mountain	n
range	n
coach	n
fear	n
friday	n
attorney	n
unless	c
nor	c
expert	n
structure	n
budget	n
insurance	n
text	n
freedom	n
crazy	j
reader	n
style	n
through	r
march	n
machine	n
november	n
generation	n
income	n
born	v
admit	v
hello	u
onto	i
sea	n
okay	j
mouth	n
throughout	i
own	v
test	v
web	n
shake	v
threat	n
solution	n
shut	v
down	i
travel	v
scientist	n
hide	v
obviously	r
refer	v
alone	r
drink	v
investigation	n
senator	n
unit	n
photograph	n
july	n
television	n
key	j
sexual	j
radio	n
prevent	v
once	c
modern	j
senate	n
violence	n
touch	v
feature	n
audience	n
evening	n
whom	p
front	i
hall	n
task	n
score	n
skin	n
suffer	v
wide	j
spring	n
experience	v
civil	j
safety	n
weekend	n
while	n
worth	i
title	n
heat	n
normal	j
hope	n
yard	n
finger	n
tend	v
mission	n
eventually	r
participant	n
hotel	n
judge	n
pattern	n
break	n
institution	n
faith	n
professional	j
reflect	v
folk	n
surface	n
fall	n
client	n
edge	n
traditional	j
council	n
device	n
firm	n
environmental	j
responsibility	n
chair	n
internet	n
october	n
by	r
funny	j
immediately	r
investment	n
ship	n
effective	j
previous	j
content	n
consumer	n
element	n
nuclear	j
spirit	n
directly	r
afraid	j
define	v
handle	v
track	n
run	n
wind	n
lack	n
cost	v
announce	v
journal	n
heavy	j
ice	n
collection	n
feed	v
soldier	n
just	j
governor	n
fish	n
shoulder	n
cultural	j
successful	j
fair	j
trust	v
suddenly	r
future	j
interested	j
deliver	v
saturday	n
editor	n
fresh	j
anybody	p
destroy	v
claim	n
critical	j
agreement	n
powerful	j
researcher	n
concept	n
willing	j
band	n
marry	v
promise	v
easily	r
restaurant	n
league	n
senior	j
capital	n
anymore	r
april	n
potential	j
etc	r
quick	j
magazine	n
status	n
attend	v
replace	v
due	i
hill	n
kitchen	n
achieve	v
screen	n
generally	r
mistake	n
along	r
strike	v
battle	n
spot	n
basic	j
very	j
corner	n
target	n
driver	n
beginning	n
religion	n
crisis	n
count	v
museum	n
engage	v
communication	n
murder	n
blow	v
object	n
express	v
huh	u
encourage	v
matter	v
blog	n
smile	v
return	n
belief	n
block	n
debt	n
fire	v
labor	n
understanding	n
neighborhood	n
contract	n
middle	n
species	n
additional	j
sample	n
involved	j
inside	r
mostly	r
path	n
concerned	j
apple	n
conduct	v
god	n
wonderful	j
library	n
prison	n
hole	n
attempt	n
complete	v
code	n
sales	n
gift	n
refuse	v
increase	n
garden	n
introduce	v
roll	v
christian	j
definitely	r
like	j
lake	n
turn	n
sure	r
earn	v
plane	n
vehicle	n
examine	v
application	n
thousand	n
coffee	n
gain	v
result	v
file	n
billion	m
reform	n
ignore	v
welcome	v
gold	n
jump	v
planet	n
location	n
bird	n
amazing	j
principle	n
promote	v
search	n
nine	m
alive	j
possibility	n
sky	n
otherwise	r
remind	v
healthy	j
fit	v
horse	n
advantage	n
commercial	j
steal	v
basis	n
context	n
highly	r
christmas	n
strength	n
move	n
monday	n
mean	n
alone	j
beach	n
survey	n
writing	n
master	n
cry	v
scale	n
resident	n
football	n
sweet	j
failure	n
reporter	n
commit	v
fight	n
one	n
associate	v
vision	n
function	n
truly	r
sick	j
average	j
human	n
stupid	j
will	n
chinese	j
connection	n
camp	n
stone	n
hundred	n
key	n
truck	n
afternoon	n
responsible	j
secretary	n
apparently	r
smart	j
southern	j
totally	r
western	j
collect	v
conflict	n
burn	v
learning	n
wake	v
contribute	v
ride	v
british	j
following	j
order	v
share	n
newspaper	n
foundation	n
variety	n
perspective	n
document	n
presence	n
stare	v
lesson	n
limit	v
appreciate	v
complete	j
observe	v
currently	r
hundred	m
fun	j
crowd	n
attack	v
apartment	n
survive	v
guest	n
soul	n
protection	n
intelligence	n
yesterday	r
somewhere	r
border	n
reading	n
terms	i
leadership	n
present	j
chief	n
attitude	n
start	n
um	u
deny	v
website	n
seriously	r
actual	j
recall	v
fix	v
negative	j
connect	v
distance	n
regular	j
climate	n
relation	n
flight	n
dangerous	j
boat	n
aspect	n
grab	v
until	i
favorite	j
like	r
january	n
independent	j
volume	n
am	r
lots	p
front	j
online	j
theater	n
speed	n
aware	j
identity	n
demand	n
extra	j
charge	v
guard	n
demonstrate	v
fully	r
tuesday	n
facility	n
farm	n
mind	v
fun	n
thousand	m
august	n
hire	v
light	j
link	n
shoe	n
institute	n
below	r
living	n
european	j
quarter	n
basically	r
forest	n
multiple	j
poll	n
wild	j
measure	v
twice	r
cross	v
background	n
settle	v
winter	n
focus	n
presidential	j
operate	v
fuck	v
view	v
daily	j
shop	n
above	r
division	n
slowly	r
advice	n
reaction	n
injury	n
it	n
ticket	n
grade	n
wow	u
birth	n
painting	n
outcome	n
enemy	n
damage	n
being	n
storm	n
shape	n
bowl	n
commission	n
captain	n
ear	n
troop	n
female	j
wood	n
warm	j
clean	j
lead	n
minister	n
neighbor	n
tiny	j
mental	j
software	n
glad	j
finding	n
lord	n
drive	n
temperature	n
quiet	j
spread	v
bright	j
cut	n
influence	n
kick	v
annual	j
procedure	n
respect	n
wave	n
tradition	n
threaten	v
primary	j
strange	j
actor	n
blame	v
active	j
cat	n
depend	v
bus	n
clothes	n
affair	n
contact	n
category	n
topic	n
victory	n
direct	j
towards	i
map	n
egg	n
ensure	v
general	n
expression	n
past	i
session	n
competition	n
possibly	r
technique	n
mine	p
average	n
intend	v
impossible	j
moral	j
academic	j
wine	n
approach	v
somehow	r
gather	v
scientific	j
african	j
cook	v
participate	v
gay	j
appropriate	j
youth	n
dress	v
straight	r
weather	n
recommend	v
medicine	n
novel	n
obvious	j
thursday	n
exchange	n
explore	v
extend	v
bay	n
invite	v
tie	v
ah	u
belong	v
obtain	v
broad	j
conclusion	n
progress	n
surprise	n
assessment	n
smile	n
feature	v
cash	n
defend	v
pound	n
correct	j
married	j
pair	n
slightly	r
loan	n
village	n
half	n
suit	n
demand	v
historical	j
meaning	n
attempt	v
supply	n
lift	v
ourselves	p
honey	n
bone	n
consequence	n
unique	j
next	i
regulation	n
award	n
bottom	n
excuse	v
familiar	j
classroom	n
search	v
reference	n
emerge	v
long	c
lunch	n
judge	v
ad	n
desire	n
instruction	n
emergency	n
thinking	n
tour	n
french	j
combine	v
moon	n
sad	j
address	n
december	n
anywhere	r
chicken	n
fuel	n
train	v
abuse	n
construction	n
wednesday	n
link	v
deserve	v
famous	j
intervention	n
grand	j
visit	n
confirm	v
lucky	j
insist	v
coast	n
proud	j
cover	n
fourth	m
cop	n
angry	j
native	j
supreme	j
baseball	n
but	i
email	n
accident	n
front	n
duty	n
growing	j
struggle	v
revenue	n
expand	v
chief	j
launch	v
trend	n
ring	n
repeat	v
breath	n
inch	n
neck	n
core	n
terrible	j
billion	n
relatively	r
complex	j
press	v
miss	n
slow	j
soft	j
generate	v
extremely	r
last	v
drink	n
forever	r
corporate	j
deep	r
prefer	v
except	c
cheap	j
literature	n
direct	v
mayor	n
male	j
importance	n
record	v
danger	n
emotional	j
knee	n
ass	n
capture	v
traffic	n
fucking	j
outside	r
now	c
train	n
plate	n
equipment	n
select	v
file	v
studio	n
expensive	j
secret	n
engine	n
adopt	v
luck	n
via	i
pm	r
panel	n
hero	n
circle	n
critic	n
solve	v
busy	j
episode	n
back	v
check	n
requirement	n
politician	n
rain	n
colleague	n
disappear	v
beer	n
predict	v
exercise	n
tired	j
democracy	n
ultimately	r
setting	n
honor	n
works	n
unfortunately	r
theme	n
issue	v
male	n
clean	v
united	j
pool	n
educational	j
empty	j
comfortable	j
investigate	v
useful	j
pocket	n
digital	j
plenty	p
entirely	r
fear	v
afford	v
sugar	n
teaching	n
conservative	j
chairman	n
error	n
bridge	n
tall	j
specifically	r
flower	n
though	r
universe	n
live	j
acknowledge	v
limit	n
coverage	n
crew	n
locate	v
balance	n
equal	j
lip	n
lean	v
zone	n
wedding	n
copy	n
score	v
joke	n
used	j
clear	v
bear	v
meal	n
review	v
minority	n
sight	n
sleep	n
russian	j
dress	n
release	n
soviet	j
profit	n
challenge	v
careful	j
gender	n
tape	n
ocean	n
unidentified	j
host	n
grant	v
circumstance	n
late	r
boss	n
declare	v
domestic	j
tea	n
organize	v
english	j
neither	r
either	d
official	j
surround	v
manner	n
surprised	j
percentage	n
massive	j
cloud	n
winner	n
honest	j
standard	j
propose	v
rely	v
plus	i
sentence	n
request	n
appearance	n
regarding	i
excellent	j
criminal	j
salt	n
beauty	n
bottle	n
component	n
under	r
fee	n
jewish	j
yours	p
dry	j
dance	n
shirt	n
tip	n
plastic	n
indian	j
mark	v
tooth	n
meat	n
stress	n
illegal	j
significantly	r
february	n
constitution	n
definition	n
uncle	n
metal	n
album	n
self	n
suppose	v
investor	n
fruit	n
holy	j
desk	n
eastern	j
valley	n
largely	r
abortion	n
chapter	n
commitment	n
celebrate	v
arrest	v
dance	v
prime	j
urban	j
internal	j
bother	v
proposal	n
shift	v
capacity	n
guilty	j
warn	v
influence	v
weak	j
except	i
catholic	j
nose	n
variable	n
convention	n
jury	n
root	n
incident	n
climb	v
hearing	n
everywhere	r
payment	n
bear	n
conclude	v
scream	v
surgery	n
shadow	n
witness	n
increasingly	r
chest	n
amendment	n
paint	v
secret	j
complain	v
extent	n
pleasure	n
nod	v
holiday	n
super	j
talent	n
necessarily	r
liberal	j
expectation	n
ride	n
accuse	v
knock	v
previously	r
wing	n
corporation	n
sector	n
fat	n
experiment	n
match	v
thin	j
farmer	n
rare	j
english	n
confidence	n
bunch	n
bet	v
cite	v
northern	j
speaker	n
breast	n
contribution	n
leaf	n
creative	j
interaction	n
hat	n
doubt	n
promise	n
pursue	v
overall	j
nurse	n
question	v
long-term	j
gene	n
package	n
weird	j
difficulty	n
hardly	r
daddy	n
estimate	v
list	v
era	n
comment	v
aid	n
vs	i
invest	v
personally	r
notion	n
explanation	n
airport	n
chain	n
expose	v
lock	v
convince	v
channel	n
carefully	r
tear	n
estate	n
initial	j
offer	n
purchase	v
guide	n
forth	r
his	p
bond	n
birthday	n
travel	n
pray	v
improvement	n
ancient	j
ought	v
escape	v
trail	n
brown	j
fashion	n
length	n
sheet	n
funding	n
meanwhile	r
fault	n
barely	r
eliminate	v
motion	n
essential	j
apart	r
combination	n
limited	j
description	n
mix	v
snow	n
implement	v
pretty	j
proper	j
part	r
marketing	n
approve	v
other	i
bomb	n
slip	v
regional	j
lack	v
muscle	n
contact	v
rise	n
0	j
likely	r
creation	n
typically	r
spending	n
instrument	n
mass	n
far	c
thick	j
kiss	v
increased	j
inspire	v
separate	j
noise	n
yellow	j
aim	v
e-mail	n
cycle	n
signal	n
app	n
golden	j
reject	v
inform	v
perception	n
visitor	n
cast	v
contrast	n
judgment	n
mean	j
rest	v
representative	n
pass	n
regime	n
merely	r
producer	n
whoa	u
route	n
lie	n
typical	j
analyst	n
account	v
elect	v
smell	v
female	n
living	j
disability	n
comparison	n
hand	v
rating	n
campus	n
assess	v
solid	j
branch	n
mad	j
somewhat	r
gentleman	n
opposition	n
fast	j
suspect	v
land	v
hit	n
aside	r
athlete	n
opening	n
prayer	n
frequently	r
employ	v
basketball	n
existing	j
revolution	n
click	v
emotion	n
fuck	n
platform	n
behind	r
frame	n
appeal	n
quote	v
potential	n
struggle	n
brand	n
enable	v
legislation	n
addition	i
lab	n
oppose	v
row	n
immigration	n
asset	n
observation	n
online	r
taste	n
decline	v
attract	v
ha	u
for	c
household	n
separate	v
breathe	v
existence	n
mirror	n
pilot	n
stand	n
relief	n
milk	n
warning	n
heaven	n
flow	n
literally	r
quit	v
calorie	n
seed	n
vast	j
bike	n
german	j
employer	n
drag	v
technical	j
disaster	n
display	v
sale	n
bathroom	n
succeed	v
consistent	j
agenda	n
enforcement	n
diet	n
mark	n
silence	n
journalist	n
bible	n
queen	n
divide	v
expense	n
cream	n
exposure	n
priority	n
soil	n
angel	n
journey	n
trust	n
relevant	j
tank	n
cheese	n
schedule	n
bedroom	n
tone	n
selection	n
date	v
perfectly	r
wheel	n
gap	n
veteran	n
below	i
disagree	v
characteristic	n
protein	n
resolution	n
whole	n
regard	v
fewer	d
engineer	n
walk	n
dish	n
waste	n
print	n
depression	n
dude	n
fat	j
present	n
upper	j
wrap	v
ceo	n
visual	j
initiative	n
rush	v
gate	n
slow	v
whenever	r
entry	n
japanese	j
gray	j
assistance	n
height	n
compete	v
rule	v
due	j
essentially	r
benefit	v
phase	n
conservative	n
recover	v
criticism	n
faculty	n
achievement	n
alcohol	n
therapy	n
offense	n
touch	n
killer	n
personality	n
landscape	n
deeply	r
reasonable	j
soon	c
suck	v
transition	n
fairly	r
column	n
wash	v
button	n
opponent	n
pour	v
immigrant	n
first	r
distribution	n
golf	n
pregnant	j
unable	j
alternative	n
favorite	n
stop	n
violent	j
portion	n
acquire	v
suicide	n
stretch	v
deficit	n
symptom	n
solar	j
complaint	n
capable	j
analyze	v
scared	j
supporter	n
dig	v
twenty	m
pretend	v
philosophy	n
childhood	n
lower	v
well	n
outside	j
dark	n
wealth	n
welfare	n
poverty	n
prosecutor	n
spiritual	j
double	j
evaluate	v
mass	j
israeli	j
shift	n
reply	v
buck	n
display	n
knife	n
round	n
tech	n
detective	n
pack	v
disorder	n
creature	n
tear	v
closely	r
industrial	j
housing	n
watch	n
chip	n
regardless	r
numerous	j
tie	n
range	v
command	n
shooting	n
dozen	m
pop	v
layer	n
bread	n
exception	n
passion	n
block	v
highway	n
pure	j
commander	n
extreme	j
publication	n
vice	j
fellow	j
win	n
mystery	n
championship	n
install	v
tale	n
liberty	n
host	v
beneath	i
passenger	n
physician	n
graduate	n
sharp	j
substance	n
atmosphere	n
stir	v
muslim	j
passage	n
pepper	n
emphasize	v
cable	n
square	n
recipe	n
load	v
beside	i
roof	n
vegetable	n
accomplish	v
silent	j
habit	n
discovery	n
total	n
recovery	n
dna	n
gain	n
territory	n
girlfriend	n
consist	v
straight	j
surely	r
proof	n
nervous	j
immediate	j
parking	n
sin	n
unusual	j
rice	n
engineering	n
advance	n
interview	v
bury	v
still	j
cake	n
anonymous	j
flag	n
contemporary	j
good	n
jail	n
rural	j
match	n
coach	v
interpretation	n
wage	n
breakfast	n
severe	j
profile	n
saving	n
brief	j
adjust	v
reduction	n
constantly	r
assist	v
bitch	n
constant	j
permit	v
primarily	r
entertainment	n
shout	v
academy	n
teaspoon	n
dream	v
transfer	v
usual	j
ally	n
clinical	j
count	n
swear	v
avenue	n
priest	n
employment	n
waste	v
relax	v
owe	v
transform	v
grass	n
narrow	j
ethnic	j
scholar	n
edition	n
abandon	v
practical	j
infection	n
musical	j
suggestion	n
resistance	n
smoke	v
prince	n
illness	n
embrace	v
trade	v
republic	n
volunteer	n
target	v
general	r
evaluation	n
mine	n
opposite	j
awesome	j
switch	v
black	n
iraqi	j
iron	n
perceive	v
fundamental	j
phrase	n
assumption	n
sand	n
designer	n
planning	n
leading	j
mode	n
track	v
respect	v
widely	r
occasion	n
pose	v
approximately	r
retire	v
elsewhere	r
festival	n
cap	n
secure	v
attach	v
mechanism	n
intention	n
scenario	n
yell	v
incredible	j
spanish	j
strongly	r
racial	j
transportation	n
pot	n
boyfriend	n
consideration	n
prior	i
retirement	n
rarely	r
joint	j
doubt	v
preserve	v
enormous	j
cigarette	n
factory	n
valuable	j
clip	n
electric	j
giant	n
slave	n
submit	v
effectively	r
christian	n
monitor	v
wonder	n
resolve	v
remaining	j
participation	n
stream	n
rid	v
origin	n
teen	n
particular	r
congressional	j
bind	v
coat	n
tower	n
license	n
twitter	n
impose	v
innocent	j
curriculum	n
mail	n
estimate	n
insight	n
investigator	n
virus	n
hurricane	n
accurate	j
provision	n
strike	n
communicate	v
cross	n
vary	v
jacket	n
increasing	j
green	n
equally	r
pay	n
in	c
light	v
implication	n
fiction	n
protest	n
mama	n
imply	v
twin	n
pant	n
another	p
ahead	i
bend	v
shock	n
exercise	v
criteria	n
arab	j
dirty	j
ring	v
toy	n
potentially	r
assault	n
peak	n
anger	n
boot	n
dramatic	j
peer	n
enhance	v
math	n
slide	v
favor	n
pink	j
dust	n
aunt	n
lost	j
prospect	n
mood	n
mm-hmm	u
settlement	n
rather	c
justify	v
depth	n
juice	n
formal	j
virtually	r
gallery	n
tension	n
throat	n
draft	n
reputation	n
index	n
normally	r
mess	n
joy	n
steel	n
motor	n
enterprise	n
salary	n
moreover	r
giant	j
cousin	n
ordinary	j
graduate	v
dozen	n
evolution	n
so-called	j
helpful	j
competitive	j
lovely	j
fishing	n
anxiety	n
professional	n
carbon	n
essay	n
islamic	j
honor	v
drama	n
odd	j
evil	j
stranger	n
belt	n
urge	v
toss	v
fifth	m
formula	n
potato	n
monster	n
smoke	n
telephone	n
rape	n
palm	n
jet	n
navy	n
excited	j
plot	n
angle	n
criticize	v
prisoner	n
discipline	n
negotiation	n
damn	j
butter	n
desert	n
complicated	j
prize	n
blind	j
assign	v
bullet	n
awareness	n
sequence	n
illustrate	v
drop	n
pack	n
provider	n
fucking	r
minor	j
activist	n
poem	n
vacation	n
weigh	v
gang	n
privacy	n
clock	n
arrange	v
penalty	n
stomach	n
concert	n
originally	r
statistics	n
electronic	j
properly	r
bureau	n
wolf	n
and/or	c
classic	j
recommendation	n
exciting	j
maker	n
dear	j
impression	n
broken	j
battery	n
narrative	n
process	v
arise	v
kid	v
sake	n
delivery	n
forgive	v
visible	j
heavily	r
junior	j
rep	n
diversity	n
string	n
lawsuit	n
latter	d
cute	j
deputy	n
restore	v
buddy	n
psychological	j
besides	r
intense	j
friendly	j
evil	n
lane	n
hungry	j
bean	n
sauce	n
print	v
dominate	v
testing	n
trick	n
fantasy	n
absence	n
offensive	j
symbol	n
recognition	n
detect	v
tablespoon	n
construct	v
hmm	u
arrest	n
approval	n
aids	n
whereas	c
defensive	j
independence	n
apologize	v
top	i
asian	j
rose	n
ghost	n
involvement	n
permanent	j
wire	n
whisper	v
mouse	n
airline	n
founder	n
objective	n
nowhere	r
alternative	j
phenomenon	n
evolve	v
not	c
exact	j
silver	n
cent	n
universal	j
teenager	n
crucial	j
viewer	n
schedule	v
ridiculous	j
chocolate	n
sensitive	j
bottom	j
grandmother	n
missile	n
roughly	r
constitutional	j
adventure	n
genetic	j
advance	v
related	j
swing	v
ultimate	j
manufacturer	n
unknown	j
wipe	v
crop	n
survival	n
line	v
dimension	n
resist	v
request	v
roll	n
shape	v
darkness	n
guarantee	v
historic	j
educator	n
rough	j
personnel	n
race	v
confront	v
terrorist	n
royal	j
elite	n
occupy	v
emphasis	n
wet	j
destruction	n
raw	j
inner	j
proceed	v
violate	v
chart	n
pace	n
finance	n
champion	n
snap	v
suspect	n
advise	v
initially	r
advanced	j
unlikely	j
barrier	n
advocate	n
label	n
access	v
horrible	j
burden	n
violation	n
unlike	i
idiot	n
lifetime	n
working	j
fund	v
ongoing	j
react	v
routine	n
presentation	n
supply	v
gear	n
photograph	v
mexican	j
stadium	n
translate	v
mortgage	n
sheriff	n
clinic	n
spin	v
coalition	n
naturally	r
hopefully	r
mix	n
menu	n
smooth	j
advertising	n
interpret	v
plant	v
dismiss	v
muslim	n
apparent	j
arrangement	n
incorporate	v
split	v
brilliant	j
storage	n
framework	n
honestly	r
chase	v
sigh	v
assure	v
utility	n
taste	v
aggressive	j
cookie	n
terror	n
free	v
worth	n
wealthy	j
update	v
forum	n
alliance	n
possess	v
empire	n
curious	j
corn	n
neither	d
calculate	v
hurry	v
testimony	n
elementary	j
transfer	n
stake	n
precisely	r
bite	v
given	j
substantial	j
depending	i
glance	v
tissue	n
concentration	n
developer	n
found	v
ballot	n
consume	v
overcome	v
biological	j
chamber	n
similarly	r
stick	n
dare	v
developing	j
tiger	n
ratio	n
lover	n
expansion	n
encounter	v
occasionally	r
unemployment	n
pet	n
awful	j
laboratory	n
administrator	n
wind	v
quarterback	n
rocket	n
preparation	n
relative	n
confident	j
strategic	j
marine	j
quote	n
publisher	n
innovation	n
highlight	v
nut	n
fighter	n
rank	n
electricity	n
instance	n
fortune	n
freeze	v
variation	n
armed	j
negotiate	v
laughter	n
wisdom	n
correspondent	n
mixture	n
murder	v
assistant	n
retain	v
tomato	n
indian	n
testify	v
ingredient	n
since	r
galaxy	n
qualify	v
scheme	n
gop	n
shame	n
concentrate	v
contest	n
introduction	n
boundary	n
tube	n
versus	i
chef	n
regularly	r
ugly	j
screw	v
load	n
tongue	n
palestinian	j
fiscal	j
creek	n
hip	n
accompany	v
decline	n
terrorism	n
respondent	n
narrator	n
voting	n
refugee	n
assembly	n
fraud	n
limitation	n
house	v
partnership	n
store	v
crash	n
surprise	v
representation	n
hold	n
ministry	n
flat	j
wise	j
witness	v
excuse	n
register	v
comedy	n
purchase	n
tap	v
infrastructure	n
organic	j
islam	n
diverse	j
favor	v
intellectual	j
tight	j
port	n
fate	n
market	v
absolute	j
dialogue	n
plus	n
frequency	n
tribe	n
external	j
appointment	n
convert	v
surprising	j
mobile	j
establishment	n
worried	j
bye	u
shopping	n
celebrity	n
congressman	n
impress	v
taxpayer	n
adapt	v
publicly	r
pride	n
clothing	n
rapidly	r
domain	n
mainly	r
ceiling	n
alter	v
shelter	n
random	j
obligation	n
shower	n
beg	v
asleep	j
musician	n
extraordinary	j
dirt	n
pc	n
bell	n
smell	n
damage	v
ceremony	n
clue	n
guideline	n
comfort	n
near	j
pregnancy	n
borrow	v
conventional	j
tourist	n
incentive	n
custom	n
cheek	n
tournament	n
double	v
satellite	n
nearby	j
comprehensive	j
stable	j
medication	n
script	n
educate	v
efficient	j
risk	v
welcome	j
scare	v
psychology	n
logic	n
economics	n
update	n
nevertheless	r
devil	n
thirty	m
beat	n
charity	n
fiber	n
wave	v
ideal	j
friendship	n
net	n
motivation	n
differently	r
reserve	n
observer	n
humanity	n
survivor	n
fence	n
quietly	r
humor	n
major	n
funeral	n
spokesman	n
extension	n
loose	j
sink	v
historian	n
ruin	v
balance	v
chemical	n
singer	n
drunk	j
swim	v
onion	n
specialist	n
missing	j
white	n
pan	n
distribute	v
silly	j
deck	n
reflection	n
shortly	r
database	n
flow	v
remote	j
permission	n
remarkable	j
everyday	j
lifestyle	n
sweep	v
naked	j
sufficient	j
lion	n
consumption	n
capability	n
practice	v
emission	n
sidebar	n
crap	n
dealer	n
measurement	n
vital	j
impressive	j
bake	v
fantastic	j
adviser	n
yield	v
mere	j
imagination	n
radical	j
tragedy	n
scary	j
consultant	n
correct	v
lieutenant	n
upset	v
attractive	j
acre	n
drawing	n
defeat	v
newly	r
scandal	n
ambassador	n
ooh	u
spot	v
content	j
round	j
bench	n
guide	v
counter	n
chemical	j
odds	n
rat	n
horror	n
appeal	v
vulnerable	j
prevention	n
square	j
segment	n
ban	v
tail	n
constitute	v
badly	r
bless	v
literary	j
magic	j
implementation	n
legitimate	j
slight	j
crash	v
strip	n
desperate	j
distant	j
preference	n
politically	r
feedback	n
health-care	n
criminal	n
can	n
italian	j
detailed	j
buyer	n
wrong	r
cooperation	n
profession	n
incredibly	r
orange	j
killing	n
sue	v
photographer	n
running	j
engagement	n
differ	v
paint	n
pitch	n
extensive	j
salad	n
stair	n
notice	n
grace	n
divorce	n
vessel	n
pig	n
assignment	n
distinction	n
fit	j
circuit	n
acid	n
canadian	j
flee	v
efficiency	n
memorial	n
proposed	j
blue	n
entity	n
iphone	n
punishment	n
pause	v
pill	n
rub	v
romantic	j
myth	n
economist	n
latin	j
decent	j
assistant	j
craft	n
poetry	n
terrorist	j
thread	n
wooden	j
confuse	v
subject	i
privilege	n
coal	n
fool	n
cow	n
characterize	v
pie	n
decrease	v
resort	n
legacy	n
re	i
stress	v
frankly	r
matter	d
cancel	v
derive	v
dumb	j
scope	n
formation	n
grandfather	n
hence	r
wish	n
margin	n
wound	n
exhibition	n
legislature	n
furthermore	r
portrait	n
catholic	n
sustain	v
uniform	n
painful	j
loud	j
miracle	n
harm	n
zero	m
tactic	n
mask	n
calm	v
inflation	n
hunting	n
physically	r
final	n
flesh	n
temporary	j
fellow	n
nerve	n
lung	n
steady	j
headline	n
sudden	j
successfully	r
defendant	n
pole	n
satisfy	v
entrance	n
aircraft	n
withdraw	v
cabinet	n
relative	j
repeatedly	r
happiness	n
admission	n
correlation	n
proportion	n
dispute	n
candy	n
reward	n
counselor	n
recording	n
pile	n
explosion	n
appoint	v
couch	n
cognitive	j
furniture	n
significance	n
grateful	j
magic	n
suit	v
commissioner	n
shelf	n
tremendous	j
warrior	n
physics	n
garage	n
flavor	n
squeeze	v
prominent	j
fifty	m
fade	v
oven	n
satisfaction	n
discrimination	n
recession	n
allegation	n
boom	n
weekly	j
lately	r
restriction	n
diamond	n
document	v
crack	v
conviction	n
heel	n
fake	j
fame	n
shine	v
swing	n
playoff	n
actress	n
cheat	v
format	n
controversy	n
auto	n
grant	n
grocery	n
headquarters	n
rip	v
rank	v
shade	n
regulate	v
meter	n
olympic	j
pipe	n
patient	j
celebration	n
handful	n
copyright	n
dependent	j
signature	n
bishop	n
strengthen	v
soup	n
entitle	v
whoever	p
carrier	n
anniversary	n
pizza	n
ethics	n
legend	n
eagle	n
scholarship	n
crack	n
research	v
membership	n
standing	n
possession	n
treaty	n
partly	r
consciousness	n
manufacturing	n
announcement	n
tire	v
no	d
makeup	n
pop	n
prediction	n
stability	n
trace	v
norm	n
irish	j
genius	n
gently	r
operator	n
mall	n
rumor	n
poet	n
tendency	n
subsequent	j
alien	n
explode	v
cool	v
controversial	j
maintenance	n
courage	n
exceed	v
tight	r
principal	n
vaccine	n
identification	n
sandwich	n
bull	n
lens	n
twelve	m
mainstream	j
presidency	n
integrity	n
distinct	j
intelligent	j
secondary	j
bias	n
hypothesis	n
fifteen	m
nomination	n
delay	n
adjustment	n
sanction	n
render	v
shop	v
acceptable	j
mutual	j
high	r
examination	n
meaningful	j
communist	j
superior	j
currency	n
collective	j
tip	v
flame	n
guitar	n
doctrine	n
palestinian	n
float	v
commerce	n
invent	v
robot	n
rapid	j
plain	j
respectively	r
particle	n
across	r
glove	n
till	c
edit	v
moderate	j
jazz	n
infant	n
summary	n
server	n
leather	n
radiation	n
prompt	v
function	v
composition	n
operating	j
assert	v
case	c
discourse	n
loud	r
dump	v
net	j
wildlife	n
soccer	n
complex	n
mandate	n
monitor	n
downtown	j
nightmare	n
barrel	n
homeless	j
globe	n
uncomfortable	j
execute	v
feel	n
trap	v
gesture	n
pale	j
tent	n
receiver	n
horizon	n
diagnosis	n
considerable	j
gospel	n
automatically	r
fighting	n
stroke	n
wander	v
duck	n
grain	n
beast	n
concern	v
remark	n
fabric	n
civilization	n
warm	v
corruption	n
collapse	n
ma'am	n
greatly	r
workshop	n
inquiry	n
cd	n
admire	v
exclude	v
rifle	n
closet	n
reporting	n
curve	n
patch	n
touchdown	n
experimental	j
earnings	n
hunter	n
fly	n
tunnel	n
corps	n
behave	v
rent	v
german	n
motivate	v
attribute	v
elderly	j
virtual	j
minimum	j
weakness	n
progressive	j
doc	n
medium	n
virtue	n
ounce	n
collapse	v
delay	v
athletic	j
confusion	n
legislative	j
facilitate	v
midnight	n
deer	n
way	r
undergo	v
heritage	n
summit	n
sword	n
telescope	n
donate	v
blade	n
toe	n
agriculture	n
park	v
enforce	v
recruit	v
favor	i
dose	n
concerning	i
integrate	v
rate	v
pitch	v
prescription	n
retail	j
adoption	n
monthly	j
deadly	j
grave	n
rope	n
reliable	j
label	v
transaction	n
lawn	n
consistently	r
mount	v
bubble	n
briefly	r
absorb	v
princess	n
log	n
blanket	n
laugh	n
kingdom	n
anticipate	v
bug	n
primary	n
dedicate	v
nominee	n
transformation	n
temple	n
sense	v
arrival	n
frustration	n
changing	j
demonstration	n
pollution	n
poster	n
nail	n
nonprofit	j
cry	n
guidance	n
exhibit	v
pen	n
interrupt	v
lemon	n
bankruptcy	n
resign	v
dominant	j
invasion	n
sacred	j
replacement	n
portray	v
hunt	v
distinguish	v
melt	v
consensus	n
kiss	n
french	n
hardware	n
rail	n
cold	n
mate	n
dry	v
korean	j
cabin	n
dining	n
liberal	n
snake	n
tobacco	n
orientation	n
trigger	v
wherever	r
seize	v
abuse	v
mess	v
punish	v
sexy	j
depict	v
input	n
seemingly	r
widespread	j
competitor	n
flip	v
freshman	n
donation	n
administrative	j
donor	n
gradually	r
overlook	v
toilet	n
pleased	j
resemble	v
ideology	n
glory	n
maximum	j
organ	n
skip	v
starting	n
brush	v
brick	n
gut	n
reservation	n
rebel	n
disappointed	j
oak	n
valid	j
instructor	n
rescue	v
racism	n
pension	n
diabetes	n
overall	r
cluster	n
eager	j
marijuana	n
combat	n
praise	v
costume	n
sixth	m
frequent	j
inspiration	n
orange	n
concrete	j
cooking	n
conspiracy	n
trait	n
van	n
institutional	j
garlic	n
drinking	n
response	i
crystal	n
stretch	n
pro	n
associate	n
helicopter	n
counsel	n
equation	n
roman	j
sophisticated	j
timing	n
pope	n
opera	n
ethical	j
mount	n
indication	n
motive	n
porch	n
reinforce	v
gaze	n
ours	p
lap	n
written	j
reverse	v
starter	n
injure	v
chronic	j
continued	j
exclusive	j
colonel	n
copy	v
beef	n
abroad	r
thanksgiving	n
intensity	n
desire	v
cave	n
basement	n
associated	j
unlike	j
fascinating	j
interact	v
illustration	n
daily	r
essence	n
container	n
driving	j
stuff	v
dynamic	j
gym	n
bat	n
plead	v
promotion	n
uncertainty	n
ownership	n
officially	r
tag	n
documentary	n
stem	n
flood	n
guilt	n
inside	n
alarm	n
turkey	n
conduct	n
diagnose	v
precious	j
swallow	v
initiate	v
fitness	n
restrict	v
gulf	n
advocate	v
mommy	n
unexpected	j
shrug	v
agricultural	j
sacrifice	n
spectrum	n
dragon	n
bacteria	n
shore	n
pastor	n
cliff	n
ship	v
adequate	j
rape	v
addition	n
tackle	v
occupation	n
compose	v
slice	n
brave	j
military	n
stimulus	n
patent	n
powder	n
harsh	j
chaos	n
kit	n
this	r
piano	n
surprisingly	r
lend	v
correctly	r
project	v
govern	v
modest	j
shared	j
psychologist	n
servant	n
overwhelming	j
elevator	n
hispanic	j
divine	j
transmission	n
butt	n
commonly	r
cowboy	n
ease	v
intent	n
counseling	n
gentle	j
rhythm	n
short	r
complexity	n
nonetheless	r
effectiveness	n
lonely	j
statistical	j
longtime	j
strain	n
firm	j
garbage	n
devote	v
speed	v
venture	n
lock	n
aide	n
subtle	j
rod	n
top	v
civilian	j
t-shirt	n
endure	v
civilian	n
basket	n
strict	j
loser	n
franchise	n
saint	n
aim	n
prosecution	n
bite	n
lyrics	n
compound	n
architecture	n
reach	n
destination	n
cope	v
province	n
sum	n
lecture	n
spill	v
genuine	j
upstairs	r
protest	v
trading	n
please	v
acceptance	n
revelation	n
march	v
indicator	n
collaboration	n
rhetoric	n
tune	v
slam	v
inevitable	j
monkey	n
till	i
protocol	n
productive	j
principal	j
finish	n
jeans	n
companion	n
convict	v
boost	v
recipient	n
practically	r
array	n
persuade	v
undermine	v
yep	u
ranch	n
scout	n
medal	n
endless	j
translation	n
ski	n
conservation	n
habitat	n
contractor	n
trailer	n
pitcher	n
towel	n
goodbye	u
harm	v
bonus	n
dramatically	r
genre	n
caller	n
exit	n
hook	n
behavioral	j
omit	v
pit	n
volunteer	v
boring	j
hook	v
suspend	v
cholesterol	n
closed	j
advertisement	n
bombing	n
consult	v
encounter	n
expertise	n
creator	n
peaceful	j
upset	j
provided	c
tablet	n
blow	n
ruling	n
launch	n
warming	n
equity	n
rational	j
classic	n
utilize	v
pine	n
past	r
bitter	j
guard	v
surgeon	n
affordable	j
tennis	n
artistic	j
download	v
suffering	n
accuracy	n
literacy	n
treasury	n
talented	j
crown	n
importantly	r
bare	j
invisible	j
sergeant	n
regulatory	j
thumb	n
colony	n
walking	n
accessible	j
damn	v
integration	n
spouse	n
award	v
excitement	n
residence	n
bold	j
adolescent	n
greek	j
doll	n
oxygen	n
finance	v
gravity	n
functional	j
palace	n
echo	v
cotton	n
rescue	n
estimated	j
program	v
endorse	v
lawmaker	n
determination	n
flash	v
simultaneously	r
dynamics	n
shell	n
hint	n
frame	v
administer	v
rush	n
christianity	n
distract	v
ban	n
alleged	j
statute	n
value	v
biology	n
republican	j
follower	n
nasty	j
evident	j
prior	j
confess	v
eligible	j
picture	v
rock	v
trap	n
consent	n
pump	n
down	n
bloody	j
hate	n
occasional	j
trunk	n
prohibit	v
sustainable	j
belly	n
banking	n
asshole	n
journalism	n
flash	n
average	v
obstacle	n
ridge	n
heal	v
bastard	n
cheer	v
apology	n
tumor	n
architect	n
wrist	n
harbor	n
handsome	j
bullshit	n
realm	n
bet	n
twist	v
inspector	n
surveillance	n
trauma	n
rebuild	v
romance	n
gross	j
deadline	n
age	v
classical	j
convey	v
compensation	n
insect	n
debate	v
output	n
parliament	n
suite	n
opposed	i
fold	v
separation	n
demon	n
eating	n
structural	j
besides	i
equality	n
logical	j
probability	n
await	v
generous	j
acquisition	n
custody	n
compromise	n
greet	v
trash	n
judicial	j
earthquake	n
insane	j
realistic	j
wake	n
assemble	v
necessity	n
horn	n
parameter	n
grip	n
modify	v
signal	v
sponsor	v
mathematics	n
hallway	n
african-american	j
any	r
liability	n
crawl	v
theoretical	j
condemn	v
fluid	n
homeland	n
technological	j
exam	n
anchor	n
spell	v
considering	c
conscious	j
vitamin	n
known	j
hostage	n
reserve	v
actively	r
mill	n
teenage	j
respect	i
retrieve	v
processing	n
sentiment	n
offering	n
oral	j
convinced	j
photography	n
coin	n
laptop	n
bounce	v
goodness	n
affiliation	n
punch	v
burst	v
bee	n
blessing	n
command	v
continuous	j
above	j
landing	n
repair	n
worry	n
ritual	n
bath	n
sneak	v
historically	r
mud	n
scan	v
reminder	n
hers	p
slavery	n
supervisor	n
quantity	n
olympics	n
pleasant	j
slope	n
skirt	n
outlet	n
curtain	n
declaration	n
seal	v
immune	j
switch	n
calendar	n
paragraph	n
identical	j
credit	v
regret	v
quest	n
flat	n
entrepreneur	n
specify	v
stumble	v
clay	n
noon	n
last	r
strip	v
elbow	n
outstanding	j
uh-huh	u
unity	n
rent	n
manipulate	v
airplane	n
portfolio	n
mysterious	j
delicious	j
northwest	n
sweat	n
profound	j
sacrifice	v
treasure	n
flour	n
lightly	r
rally	n
default	n
alongside	i
plain	n
hug	v
isolate	v
exploration	n
secure	j
limb	n
enroll	v
outer	j
charter	n
southwest	n
escape	n
arena	n
witch	n
upcoming	j
forty	m
someday	r
unite	v
courtesy	n
statue	n
fist	n
castle	n
precise	j
squad	n
cruise	n
joke	v
legally	r
embassy	n
patience	n
medium	j
thereby	r
bush	n
purple	j
peer	v
electrical	j
outfit	n
cage	n
retired	j
shark	n
lobby	n
sidewalk	n
near	r
runner	n
ankle	n
attraction	n
fool	v
artificial	j
mercy	n
indigenous	j
slap	v
tune	n
dancer	n
candle	n
sexually	r
needle	n
hidden	j
chronicle	n
suburb	n
toxic	j
underlying	j
sensor	n
deploy	v
debut	n
star	v
magnitude	n
suspicion	n
pro	j
colonial	j
icon	n
grandma	n
info	n
jurisdiction	n
iranian	j
senior	n
parade	n
seal	n
archive	n
gifted	j
rage	n
outdoor	j
ending	n
loop	n
altogether	r
chase	n
burning	j
reception	n
local	n
crush	v
premise	n
deem	v
automatic	j
whale	n
mechanical	j
credibility	n
drain	v
drift	v
loyalty	n
promising	j
tide	n
traveler	n
grief	n
metaphor	n
skull	n
pursuit	n
therapist	n
backup	n
workplace	n
instinct	n
export	n
bleed	v
shock	v
seventh	m
fixed	j
broadcast	n
disclose	v
execution	n
pal	n
chuckle	v
pump	v
density	n
correction	n
representative	j
jump	n
repair	v
kinda	r
relieve	v
teammate	n
brush	n
corridor	n
russian	n
enthusiasm	n
extended	j
root	v
alright	r
panic	n
pad	n
bid	n
mild	j
productivity	n
guess	n
tuck	v
defeat	n
railroad	n
frozen	j
minimize	v
amid	i
inspection	n
cab	n
expected	j
nonsense	n
leap	v
draft	v
rider	n
theology	n
terrific	j
accent	n
invitation	n
reply	n
israeli	n
liar	n
oversee	v
awkward	j
registration	n
suburban	j
handle	n
momentum	n
instantly	r
clerk	n
chin	n
hockey	n
laser	n
proposition	n
rob	v
beam	n
ancestor	n
creativity	n
verse	n
casual	j
objection	n
clever	j
given	c
shove	v
revolutionary	j
carbohydrate	n
steam	n
reportedly	r
glance	n
forehead	n
resume	v
slide	n
sheep	n
good	r
carpet	n
cloth	n
interior	n
full-time	j
running	n
questionnaire	n
compromise	v
departure	n
behalf	i
graph	n
diplomatic	j
thief	n
herb	n
subsidy	n
cast	n
fossil	n
patrol	n
pulse	n
mechanic	n
cattle	n
screening	n
continuing	j
electoral	j
supposedly	r
dignity	n
prophet	n
commentary	n
sort	v
spread	n
serving	n
safely	r
homework	n
allegedly	r
android	n
alpha	n
insert	v
mortality	n
contend	v
elephant	n
solely	r
hurt	j
continent	n
attribute	n
ecosystem	n
leave	n
nearby	r
olive	j
syndrome	n
minimum	n
catch	n
abstract	j
accusation	n
coming	j
sock	n
pickup	n
shuttle	n
improved	j
calculation	n
innovative	j
demographic	j
accommodate	v
jaw	n
unfair	j
tragic	j
comprise	v
faster	j
nutrition	n
mentor	n
stance	n
rabbit	n
pause	n
dot	n
contributor	n
cooperate	v
disk	n
hesitate	v
regard	i
offend	v
exploit	v
compel	v
likelihood	n
sibling	n
southeast	n
gorgeous	j
undertake	v
painter	n
residential	j
counterpart	n
believer	n
lamp	n
inmate	n
thoroughly	r
trace	n
freak	v
filter	n
pillow	n
orbit	n
purse	n
likewise	r
cease	v
passing	j
feed	n
vanish	v
instructional	j
clause	n
mentally	r
model	v
left	n
pond	n
neutral	j
shield	n
popularity	n
cartoon	n
authorize	v
combined	j
exhibit	n
sink	n
graphic	n
darling	n
traditionally	r
vendor	n
poorly	r
conceive	v
opt	v
descend	v
firmly	r
beloved	j
openly	r
gathering	n
alien	j
stem	v
fever	n
preach	v
interfere	v
arrow	n
required	j
capitalism	n
kick	n
fork	n
survey	v
meantime	n
presumably	r
position	v
racist	j
stay	n
illusion	n
removal	n
anxious	j
arab	n
organism	n
awake	j
sculpture	n
spare	v
marine	n
harassment	n
drum	n
diminish	v
helmet	n
level	j
certificate	n
tribal	j
bad	r
mmm	u
sadly	r
cart	n
spy	n
sunlight	n
delete	v
rookie	n
clarify	v
hunger	n
practitioner	n
performer	n
protective	j
jar	n
programming	n
dawn	n
salmon	n
census	n
pick	n
accomplishment	n
conscience	n
fortunately	r
minimal	j
molecule	n
supportive	j
sole	j
threshold	n
inventory	n
comply	v
monetary	j
transport	n
shy	j
drill	v
influential	j
verbal	j
reward	v
ranking	n
gram	n
grasp	v
puzzle	n
envelope	n
heat	v
classify	v
enact	v
unfortunate	j
scatter	v
cure	n
time	v
dear	u
slice	v
readily	r
damn	u
discount	n
addiction	n
emerging	j
worthy	j
marker	n
juror	n
mention	n
blend	v
businessman	n
premium	n
retailer	n
charge	i
liver	n
pirate	n
protester	n
outlook	n
elder	n
gallon	n
additionally	r
ignorance	n
chemistry	n
sometime	r
weed	n
babe	n
fraction	n
cook	n
conversion	n
object	v
tolerate	v
trail	v
drown	v
merit	n
citizenship	n
coordinator	n
validity	n
european	n
lightning	n
turtle	n
ambition	n
worldwide	r
sail	v
added	j
delicate	j
comic	n
soap	n
hostile	j
instruct	v
shortage	n
useless	j
booth	n
diary	n
gasp	v
suspicious	j
transit	n
excite	v
publishing	n
curiosity	n
grid	n
rolling	j
bow	n
cruel	j
disclosure	n
rival	n
denial	n
secular	j
flood	v
speculation	n
sympathy	n
tender	j
inappropriate	j
o'clock	r
sodium	n
divorce	v
spring	v
bang	v
challenging	j
ipad	n
sack	n
barn	n
reliability	n
hormone	n
footage	n
carve	v
alley	n
ease	n
coastal	j
cafe	n
partial	j
flexible	j
experienced	j
mixed	j
vampire	n
optimistic	j
dessert	n
well-being	n
northeast	n
specialize	v
fleet	n
availability	n
compliance	n
pin	n
pork	n
astronomer	n
like	n
forbid	v
installation	n
boil	v
nest	n
exclusively	r
goat	n
shallow	j
equip	v
equivalent	n
betray	v
willingness	n
banker	n
interval	n
gasoline	n
encouraging	j
rain	v
exchange	v
bucket	n
theft	n
laundry	n
constraint	n
dying	j
hatred	n
jewelry	n
migration	n
invention	n
loving	j
revenge	n
unprecedented	j
outline	v
sheer	j
halloween	n
sweetheart	n
spit	v
lazy	j
intimate	j
defender	n
technically	r
battle	v
cure	v
peanut	n
unclear	j
piss	v
workout	n
wilderness	n
compelling	j
eleven	m
arm	v
backyard	n
alike	r
partially	r
transport	v
guardian	n
passionate	j
scripture	n
midst	n
ideological	j
apart	i
thrive	v
sensitivity	n
trigger	n
emotionally	r
ignorant	j
explicitly	r
unfold	v
headache	n
eternal	j
chop	v
ego	n
spectacular	j
deposit	n
verdict	n
regard	n
accountability	n
nominate	v
civic	j
uncover	v
critique	n
aisle	n
tropical	j
annually	r
eighth	m
blast	n
corrupt	j
compassion	n
scratch	v
verify	v
offender	n
inherit	v
strive	v
downtown	r
chunk	n
appreciation	n
canvas	n
punch	n
short-term	j
proceedings	n
magical	j
loyal	j
aah	u
desperately	r
throne	n
brutal	j
spite	i
propaganda	n
irony	n
soda	n
projection	n
dutch	j
parental	j
disabled	j
collector	n
re-election	n
disappointment	n
comic	j
aid	v
happily	r
steep	j
fancy	j
counter	v
listener	n
whip	v
public	r
drawer	n
heck	n
developmental	j
ideal	n
ash	n
socially	r
courtroom	n
stamp	n
solo	n
trainer	n
induce	v
anytime	n
morality	n
syrian	j
pipeline	n
bride	n
instant	j
spark	v
doorway	n
interface	n
learner	n
casino	n
placement	n
cord	n
fan	v
conception	n
flexibility	n
thou	p
tax	v
elegant	j
flaw	n
locker	n
peel	v
campaign	v
twist	n
spell	n
objective	j
plea	n
goddamn	j
import	n
stack	n
gosh	u
philosophical	j
junk	n
bicycle	n
vocal	j
chew	v
destiny	n
ambitious	j
unbelievable	j
vice	n
halfway	r
jealous	j
sphere	n
invade	v
sponsor	n
excessive	j
countless	j
sunset	n
interior	j
accounting	n
faithful	j
freely	r
extract	v
adaptation	n
ray	n
depressed	j
emperor	n
wagon	n
columnist	n
jungle	n
embarrassed	j
trillion	n
breeze	n
blame	n
foster	v
venue	n
discourage	v
disturbing	j
riot	n
isolation	n
explicit	j
commodity	n
attendance	n
tab	n
consequently	r
dough	n
novel	j
streak	n
silk	n
similarity	n
steak	n
dancing	n
petition	n
viable	j
breathing	n
mm	u
balloon	n
monument	n
try	n
cue	n
sleeve	n
toll	n
reluctant	j
warrant	n
stiff	j
tattoo	n
softly	r
sudden	r
graduation	n
japanese	n
deliberately	r
consecutive	j
upgrade	v
associate	j
accurately	r
strictly	r
leak	v
casualty	n
risky	j
banana	n
blank	j
beneficial	j
shrink	v
chat	v
rack	n
rude	j
usage	n
testament	n
browser	n
processor	n
thigh	n
perceived	j
yield	n
talking	n
merchant	n
quantum	n
eyebrow	n
surrounding	j
vocabulary	n
ashamed	j
eh	u
radar	n
stunning	j
murderer	n
burger	n
collar	n
align	v
textbook	n
sensation	n
afterward	r
charm	n
sunny	j
hammer	n
keyboard	n
persist	v
wheat	n
predator	n
bizarre	j
